1
1
170
1
63
5,1,188,194,1,5,0,0
2,1,248,45,1,3,0,0
3,1,24,220,1,3,0,0
3,1,98,13,1,3,0,0
1,1,114,181,1,3,0,0
1,1,-13,40,1,3,0,0
5,1,318,-21,1,5,0,0
4,1,323,206,1,5,0,0
0,1,304,170,1,3,0,0
1,1,534,75,1,3,0,0
4,1,575,176,1,5,0,0
5,1,614,-19,1,5,0,0
2,1,1076,151,1,3,0,0
6,1,1476,126,1,5,1,2
6,1,1475,76,1,5,1,0
1,2,1733,20,0,0,0,0
2,2,1791,134,0,0,0,0
2,1,1713,177,1,3,0,0
6,1,761,156,1,5,1,0
6,1,762,48,1,5,1,0
3,1,931,193,1,3,0,0
4,1,785,202,1,5,0,0
0,1,833,32,1,3,0,0
0,1,1308,72,1,3,0,0
1,1,1379,148,1,3,0,0
4,1,1513,0,1,5,0,0
6,1,1626,184,1,5,1,0
3,1,1522,201,1,3,0,0
1,1,1691,33,1,3,0,0
1,1,1762,107,1,3,0,0
0,1,1590,68,1,3,0,0
1,2,1542,124,0,0,0,0
2,2,2114,147,0,0,0,0
1,2,2104,15,0,0,0,0
3,1,1848,29,1,3,0,0
0,1,2243,37,1,3,0,0
3,1,2354,46,1,3,0,0
6,1,2069,201,1,5,1,0
6,1,2074,6,1,5,1,0
6,1,1992,163,1,5,1,1
6,1,1993,58,1,5,1,0
6,1,1918,108,1,5,1,0
9,1,2225,110,1,5,1,0
6,1,1020,106,1,5,1,0
6,1,1021,188,1,5,1,0
6,1,1021,19,1,5,1,0
3,1,1185,68,1,3,0,0
0,1,1202,156,1,3,0,0
9,1,1260,106,1,5,1,1
9,1,625,103,1,5,1,3
0,2,817,0,0,0,0,0
1,1,2294,194,1,3,0,0
1,1,2478,-10,1,3,0,0
5,1,2480,195,1,5,0,0
1,1,2396,173,1,3,0,0
0,1,2607,209,1,3,0,0
7,1,478,101,1,4,1,0
6,1,1255,184,1,5,1,0
6,1,1627,18,1,5,1,0
6,1,1257,18,1,5,1,0
6,1,503,19,1,5,1,0
10,1,2645,86,1,15,1,0
6,1,502,184,1,5,1,0
