3
3
170
3
64
3,1,24,220,1,3,0,0
3,1,98,13,1,3,0,0
1,1,-13,40,1,3,0,0
5,1,318,-21,1,5,0,0
4,1,323,206,1,5,0,0
1,2,1733,20,0,0,0,0
2,2,1791,134,0,0,0,0
3,1,931,193,1,3,0,0
4,1,785,202,1,5,0,0
4,1,1513,0,1,5,0,0
6,1,1626,184,1,5,1,0
6,1,1626,17,1,5,1,0
1,2,1542,124,0,0,0,0
4,1,430,183,1,5,0,0
5,1,662,182,1,5,0,0
4,1,663,-13,1,5,0,0
2,2,861,-24,0,0,0,0
6,1,513,50,1,5,1,0
3,1,438,8,1,3,2,0
5,1,208,188,1,5,0,0
1,1,776,27,1,3,0,0
0,1,772,179,1,3,0,0
2,2,1091,153,0,0,0,0
1,2,1150,38,0,0,0,0
0,1,1241,214,1,3,0,0
6,1,1021,21,1,5,1,0
6,1,1022,189,1,5,1,0
4,1,2028,-26,1,5,0,0
4,1,2034,187,1,5,0,0
3,1,1720,191,1,3,0,0
1,2,93,189,0,0,0,0
6,1,512,157,1,5,1,0
2,2,1375,22,0,0,0,0
6,1,828,54,1,5,1,0
6,1,829,158,1,5,1,0
1,2,743,79,0,0,0,0
6,1,1951,199,1,5,1,0
6,1,1954,16,1,5,1,0
6,1,1359,201,1,5,1,0
6,1,1360,6,1,5,1,0
6,1,1289,48,1,5,1,0
6,1,1289,154,1,5,1,1
10,1,2644,85,1,15,1,0
6,1,2215,6,1,5,1,0
6,1,2214,201,1,5,1,0
5,1,1483,206,1,5,0,0
6,1,2542,102,1,5,1,0
6,1,2154,154,1,5,1,1
6,1,2156,49,1,5,1,2
9,1,1815,99,1,5,1,3
7,1,458,103,1,5,1,0
7,1,1022,102,1,5,1,0
2,2,185,57,0,0,0,0
8,1,1626,100,1,5,2,0
8,1,1954,99,1,5,2,0
2,1,585,25,1,3,0,0
3,1,570,216,1,3,0,0
0,1,202,11,1,3,0,0
0,1,2029,172,1,3,0,0
8,1,1222,101,1,5,2,0
8,1,2266,100,1,5,2,0
0,2,2281,0,0,0,0,0
6,1,675,101,1,5,1,0
0,1,1251,-7,1,3,0,0
