4
4
170
4
54
1,2,59,35,0,0,0,0
2,2,179,98,0,0,0,0
0,1,182,55,1,3,0,0
2,1,304,16,1,3,0,0
3,1,88,178,1,3,0,0
6,1,682,16,1,5,1,0
3,1,1114,203,1,3,0,0
2,2,1143,-53,0,0,0,0
1,2,1181,166,0,0,0,0
10,1,2637,85,1,15,1,0
1,2,2237,61,0,0,0,0
2,2,2387,-44,0,0,0,0
2,2,2345,176,0,0,0,0
6,1,682,190,1,5,1,0
3,1,357,186,1,3,0,0
1,1,455,18,1,3,0,0
4,1,487,206,1,5,0,0
6,1,598,57,1,5,1,0
6,1,598,150,1,5,1,0
0,1,835,32,1,3,0,0
9,1,816,102,1,5,1,0
9,1,1556,100,1,5,1,0
6,1,1002,190,1,5,1,0
6,1,1002,17,1,5,1,0
6,1,1354,16,1,5,1,0
6,1,1284,57,1,5,1,1
6,1,1354,191,1,5,1,0
6,1,1286,149,1,5,1,0
8,1,1717,103,1,5,2,0
2,2,2040,86,0,0,0,0
8,1,2148,101,1,5,2,0
5,1,2094,-25,1,5,0,0
3,1,893,215,1,3,0,0
2,1,936,-14,1,3,0,0
1,2,873,57,0,0,0,0
7,1,2504,98,1,5,1,2
6,1,2574,27,1,5,1,0
6,1,2574,180,1,5,1,0
1,2,414,76,0,0,0,0
2,2,733,102,0,0,0,0
6,1,1782,50,1,5,1,0
6,1,1899,4,1,5,1,0
6,1,1783,162,1,5,1,0
6,1,1897,202,1,5,1,0
6,1,2197,48,1,5,1,3
6,1,2197,155,1,5,1,1
6,1,2310,9,1,5,1,0
6,1,2310,198,1,5,1,0
7,1,1148,99,1,5,1,0
7,1,522,102,1,5,1,0
6,1,1421,99,1,5,1,0
0,2,1403,0,0,0,0,0
6,1,741,99,1,5,1,0
2,2,1016,68,0,0,0,0
