5
5
170
5
53
0,1,51,51,1,3,0,0
3,1,72,185,1,3,0,0
3,1,348,17,1,3,0,0
2,2,324,98,0,0,0,0
1,2,484,-24,0,0,0,0
2,2,757,181,0,0,0,0
1,2,508,194,0,0,0,0
2,2,629,62,0,0,0,0
1,2,787,-12,0,0,0,0
10,1,2637,90,1,20,1,0
6,1,2582,44,1,5,1,0
6,1,2582,163,1,5,1,0
6,1,663,14,1,5,1,0
6,1,662,191,1,5,1,0
6,1,561,58,1,5,1,0
6,1,562,150,1,5,1,0
2,2,1698,-26,0,0,0,0
1,1,1603,26,1,3,0,0
1,2,1613,145,0,0,0,0
6,1,1142,58,1,5,1,0
6,1,1142,150,1,5,1,0
4,1,160,-14,1,5,0,0
1,1,236,181,1,3,0,0
6,1,1193,188,1,5,1,0
6,1,1194,13,1,5,1,0
6,1,1557,197,1,5,1,0
6,1,1839,198,1,5,1,1
6,1,1838,9,1,5,1,2
1,2,202,80,0,0,0,0
4,1,-26,123,1,5,0,0
8,1,872,13,1,5,2,0
8,1,873,191,1,5,2,0
0,1,346,224,1,3,0,0
6,1,458,103,1,5,1,0
6,1,1504,50,1,5,1,3
6,1,1557,11,1,5,1,0
8,1,2030,49,1,5,2,0
8,1,2029,150,1,5,2,0
8,1,2443,98,1,5,2,0
0,2,2196,0,0,0,0,0
8,1,1660,103,1,5,2,0
6,1,1504,153,1,5,1,0
9,1,1836,104,1,5,1,0
6,1,2082,9,1,5,1,0
6,1,2081,198,1,5,1,0
2,2,1908,151,0,0,0,0
1,2,1893,63,0,0,0,0
7,1,797,104,1,5,1,0
9,1,840,104,1,5,1,0
9,1,1004,103,1,5,1,0
9,1,2210,101,1,5,1,0
7,1,1356,104,1,5,1,1
0,2,921,0,0,0,0,0
