2
2
170
2
63
5,1,188,194,1,5,0,0
3,1,24,220,1,3,0,0
3,1,98,13,1,3,0,0
1,1,114,181,1,3,0,0
5,1,318,-21,1,5,0,0
2,2,1791,134,0,0,0,0
2,2,2114,147,0,0,0,0
1,2,2104,15,0,0,0,0
3,1,1848,29,1,3,0,0
0,1,2243,37,1,3,0,0
10,1,2645,78,1,15,1,0
1,1,2294,194,1,3,0,0
1,1,2478,-10,1,3,0,0
4,1,2558,46,1,5,0,0
5,1,2480,195,1,5,0,0
1,1,2396,173,1,3,0,0
0,1,2607,209,1,3,0,0
1,2,657,42,0,0,0,0
2,2,718,157,0,0,0,0
2,2,977,6,0,0,0,0
2,2,1035,162,0,0,0,0
4,1,774,-23,1,5,0,0
5,1,594,172,1,5,0,0
2,1,605,10,1,3,0,0
1,1,818,195,1,3,0,0
3,1,467,9,1,3,0,0
4,1,417,177,1,5,0,0
3,1,318,186,1,3,0,0
2,1,219,6,1,3,0,0
1,1,1585,36,1,3,0,0
9,1,1641,103,1,5,1,0
9,1,1133,103,1,5,1,0
6,1,1498,198,1,5,1,0
6,1,1498,10,1,5,1,0
6,1,1418,55,1,5,1,0
6,1,1417,157,1,5,1,1
6,1,536,51,1,5,1,0
6,1,536,155,1,5,1,0
6,1,911,10,1,5,1,0
6,1,866,42,1,5,1,0
6,1,911,197,1,5,1,0
6,1,867,163,1,5,1,0
9,1,719,103,1,5,1,0
9,1,2241,103,1,5,1,0
6,1,1997,54,1,5,1,1
6,1,1997,157,1,5,1,0
6,1,1752,10,1,5,1,0
6,1,1752,196,1,5,1,0
3,1,1602,186,1,3,0,0
0,1,1676,17,1,3,0,0
6,1,457,103,1,5,1,0
1,2,1208,98,0,0,0,0
1,2,1690,71,0,0,0,0
2,2,1250,-53,0,0,0,0
6,1,2077,10,1,5,1,0
6,1,2074,197,1,5,1,0
6,1,1179,10,1,5,1,0
6,1,1180,197,1,5,1,0
8,1,1337,103,1,5,2,0
3,1,2359,11,1,3,0,0
7,1,2505,104,1,5,1,2
7,1,1059,104,1,5,1,3
8,1,1919,104,1,5,2,0
